Les niveaux :
0 -> air
4 -> tuyeau
5 -> eau
9 -> pic
1 -> bloc
2 -> bloc piece


#1
00000000000000000000000000000000000000000000000000000000000000000000O00000000000000000000000000000000000000000000000000000000000000000000000
00000010000000000000000000000000000000000000000000000000000000000000O00000000000000000000000000000000000000000000000000000000000000000000000
00000000000000000000000000000000000020000000000000000000000000000000O00000000000000000000000000000000000000000000000000000000000000000000000
00000000000000000000000000000000000000000000000000000000000000001000S00000000000000000000000000000000000000000000000000000000000000000000000
00001121100000000000112100011000000000000000000000000000000000011000S00000000000000000000000000000000000000000000000000000000000000000000000
00000000000000000100000000000000001010100000000010000002000000121000S00000000000000000000000000000000000000000000000000000000000000000000000
00000000000000001100000000000000000000000000010011000000000001211000S00000000000000000000000000000000000000000000000000000000000000000000000
00000000000000012100000000000000000000000000110011100000000012121000S00000000000000000000000000000000000000000000000000000000000000000000000
00000000000000121100000000000000000000000001110011110000000121211000S00000000000000000000000000000000000000000000000000000000000000000000000
11111111111111111111111110001111111111111111110011111111111212121111D11000000000000000000000000000000000000000000000000000000000000000000000
@


#2
0000000000000000000000000000000000000000000000000000000000000000000000000000000000000000000000000000000000000000000000000000O000000000000000
0000000000000000000000000000000000000000000000000000000000000000000000000000000000000000000000000000000000000000000000000000O000000000000000
0000000000000000001110000000000000000000000000000000000000000000000000000000000000000000000000000000000000000000000000111000O000000000000000
0000000000000000000001000000000000000000000000000000000000000000000100000001000001000000000000000000000000000000000001000000S000000000000000
0000000000000000200001100000000000000000000000000000000000000000001000000010000010000000000000000000000000000000000090000000S000000000000000
0000000000000000000001110000000000000000000000000000000000000000010000000100000100000000000000000000000000000000001100000000S000000000000000
0000000000000010000001111000000000000000110000110000120000000000200000001000001000000000000000000000000000090000110000000000S000000000000000
0000000000000111111111111100000000000110000110000110001000000001000000010000010000000000000000001119111001111100000000000000S000000000000000
0000000000001111111111111110000000000000000000000000000110000000000000000000000000000000000001100000000000000000000000000000S000000000000000
1111111111111111111111111111111111111111111111111111111111111111111111111111111111111111111100000000000000000000000000000111D110000000000000
@

 
 
#3
00000000000000000000000000000000000000000000000000000001111111111111111111111000000000000000000000000000000000000000000O00000000000000000000
00000000000000000000000000000000000000000000000000000001111111111111111111111000000000000000000000000000000000000000000O00000000000000000000
00000000000000000000000000000000000000002000000000000001111111111111111111111000000000000000000000000000000000000010100O00000000000000000000
00000000000000000020000000000000000000000000000000000001111111110000900001111000000000000000000000000000000000010111100S00000000000000000000
00000000000000000000000000000000000000000000000000000001111111110000000001111000000000000000000000000000000010111111100S00000000000000000000
00000000000000000222000000000000000000011111111111111111111111110000000001111000000000000000000000000000010111111111100S00000000000000000000
00000000000000010000001000000000000011000000000000000000000000000011111000000000000000000000000000000010111111111111100S00000000000000000000
00000000000000111111111100000000011000000000000000000000000000000011111000000000000000000000000000010111111111111111100S00000000000000000000
00000000000000000000000000000000000000000000000000000000001111111111111111100000000010101010101010111111111111111111100S00000000000000000000
11111111111111111111111111111111111111111111111111111111111111111111111111111111111111111111111111111111111111111111111D11000000000000000000
@



#4
000000000000000000000000000000000000000002121121121121020000000000000000000000000000000000000000000000000000000000000000000000000000000O0000
000000000000000000000000000000000000000001000000000000000000000000000000000000000000000001111100000000000000000000000000000000000000000O0000
000000000000000000000000000000000000000002000000000000000000000000000000000000000000000019999910000000000000000000100000000000000001000O0000
000000000000000000000000000000000000000001001111111111111000000000000000000000000000000019191910000000000000000001100000000000000001000O0000
000000000000000000000000000000000000000002010000000000001011100000000000000000000000000019191910000000000000000011100000000000000001000O0000
000000000002000000200000000000000000000001000000000000001000011100000000000000000000000001999100000000000010000111100000000000000001000O0000
000000000000000000000000000000000000000002121121121100001000000000000000000200000000000001919100000000000011111111100000010001000001000O0000
000000000001000000100000000000000000000000000000000010001000000000000000000000000000000001111100000000000111111111100010000000000001000O0000
000000000011111111110101010101010000000000000000000000001999999910000000000000000000000000000000000010001111111111100000000000000000000O0000
111111111000000000009090909090909111111111111111111111111000000011111111111111111111111111111111111111111111111111111111111111111111111H1111
@


#5
111111111111111111111111111111111111111111111112111111111111111111111O0000000000000000000000000000000000000000000000000000000000000000000000
100000000000000200100000001000100000000000000000000100000000000000000O0000000000000000000000000000000000000000000000000000000000000000000000
100020000000000000100011101000000000000002000000000000000000000000000O0000000000000000000000000000000000000000000000000000000000000000000000
100000000000000000100000000910010000000000000001000110000010000000000S0000000000000000000000000000000000000000000000000000000000000000000000
100000000000000100101000000100000000200000000011000000000000000000000S0000000000000000000000000000000000000000000000000000000000000000000000
100010000000001100100001000100000000000001000111001000000011000000000S0000000000000000000000000000000000000000000000000000000000000000000000
100000000000011100000000001000101000000011000000000000100000001001000S0000000000000000000000000000000000000000000000000000000000000000000000
100000010000111000000100000019100000100111000000010000000100011001100S0000000000000000000000000000000000000000000000000000000000000000000000
100000110001111000000000000001000001100000000000000100000009111001110S0000000000000000000000000000000000000000000000000000000000000000000000
111111111111111100010000001100000011100000000000100000100001111001111D0000000000000000000000000000000000000000000000000000000000000000000000
@

#6
14411111111111111111111111111111111111111111111111111111111111111111111O00000000000000000000000000000000000000000000000000000000000000000000
04400010000000000000000000000000000000011111111111111111111111111111111O00000000000000000000000000000000000000000000000000000000000000000000
04400000000000000000000000002000000000001111111111111111111111111111111O00000000000000000000000000000000000000000000000000000000000000000000
00000000000000000000000000000000000000000111111111111111111111111111111S00000000000000000000000000000000000000000000000000000000000000000000
00000000000000000000000000011100000000000011111111111111111111111111111S00000000000000000000000000000000000000000000000000000000000000000000
00000000110000000000000000000000000000000000000000000000000000000000000S00000000000000000000000000000000000000000000000000000000000000000000
00012100110000000000000011101110000000000000000000000000900900000090000S00000000000000000000000000000000000000000000000000000000000000000000
00000000110001110000001000000000100000000000900090009000000009000000000S00000000000000000000000000000000000000000000000000000000000000000000
00000000000100000100001000000000110101000111111111111111111111111111111S00000000000000000000000000000000000000000000000000000000000000000000
11111111111155555111111555555551110000011111110011111111111111111111111D00000000000000000000000000000000000000000000000000000000000000000000
@